# # # # # # # # # # # # # # #
# P . . . . . . . . . . . . #
# # # # # # # # . # . . # . #
# . # . . . . . . # . . # . #
# . # . # # # # # # # # # # #
# . . . . . . . # # # # . . #
# # # # # # # . . . . . . # #
# . . . . . . . # # . # . # #
# . # # # . # # # # # # . . #
# . # # # . . . . # # # # . # 
# # # # # . # # # # # . . . # 
# # # # # . . . . # # # . . #
# . . . . . # . . # . . . # #
# # # . . . # # G . . # # # # 
# # # # # # # # . # # # # # #